5 5
1 1

0 1 1 2 6
0 4 0 1 6
3 1 0 1 6
1 5 0 1 0
7 0 0 1 7